--[Info]--
Name:    Test_Level_1
Tileset: Dirt
Scale:   16
--[/Info]--

--[Map]--
             *****                     
       ********G***********            
   *B***GT*G....***..***..*******      
   ****...................B*.....**    
  B***...........................**    
  *..........................TG..**    
 *...........................BB..**    
 *........***...........*********      
**..**....**.....***...***********     
*...**....**......**............***    
*..***G*****......................**   
*..*..ff.f.f.....................**    
*..*..f.f.ff......P.....*****.....*    
**.***TGG***............****.......*   
**..**GG****.....****...**..........*  
**..**...ff.............**...*......*  
 *.......ff.............**.***......*  
 **......fff*...........***B***....*   
  ***..********........************    
  *B*..*T********.......*G***          
   **..****...***G*......******        
  ***...*.....**T****.........***      
   ***..............**...........***   
    **..............***...........***  
     *******........**********......*  
           **......**         *.....*  
            **....**           *....*  
             **...*           *.....** 
           ****..**           *......* 
          *****...*          *.....*** 
         ******....**********........* 
         ******......................* 
         *******....................*  
         *******................****   
         ***********************       
--[/Map]--